I	en
of	en
in	en
you	en
accha	hi
ho	hi
this	en
my	en
for	en
aur	hi
h	hi
it	en
have	en
on	en
not	en
we	en
but	en
with	en
like	en
be	en
u	en
who	en
as	en
will	en
am	univ
IITB	univ
up	en
get	en
when	en
toh	hi
just	en
ab	hi
her	en
had	en
Aur	hi
an	en
his	en
i	en
ye	hi
got	en
girl	en
aa	hi
very	en
some	en
never	en
love	en
Accha	hi
more	en
ha	univ
too	en
go	en
This	en
main	hi
nai	hi
Ye	hi
But	en
been	en
Qandeel	univ
par	hi
okkk	univ
no	en
hmmm	univ
nhi	hi
IIT	univ
feel	en
new	en
much	en
did	en
Sharma	univ
jab	hi
hum	hi
Girl	en
Baloch	univ
mere	hi
In	en
see	en
log	hi
into	en
has	hi
any	en
Ab	hi
You	en
lo	hi
last	en
here	en
Afridi	univ
tum	hi
r	en
My	en
its	en
hot	en
Hmm	univ
tell	en
Ho	hi
din	hi
something	en
sath	hi
real	en
Par	hi
n	en
mei	hi
man	en
Main	hi
lol	univ
late	en
It	en
g	hi
check	en
U	en
take	en
sir	en
mat	hi
M2K	univ
lot	en
Kohli	univ
Dhoni	univ
A	en
We	en
rhi	hi
rha	hi
make	en
lag	hi
kardo	hi
hone	hi
change	en
bus	hi
1st	en
wale	hi
T20	univ
re	hi
ram	univ
off	en
lab	en
Haha	univ
friend	en
FOR	en
Dear	en
bohot	hi
talking	en
shoib	univ
party	en
okkkk	univ
Love	en
feeling	en
every	en
beta	hi
acha	hi
run	en
pass	hi
No	en
mood	en
misbah	univ
met	en
Hum	hi
hay	hi
haha	univ
gyi	hi
film	en
d	en
door	en
dhoni	univ
badiya	hi
aise	hi
2nd	en
stop	en
Ram	univ
pad	hi
New	en
Nai	hi
M	en
Misbah	univ
Mere	hi
Man	en
kohli	univ
khush	hi
Khaila	univ
IPL	univ
For	en
fans	en
endsem	en
Darmian	hi
bola	hi
baloch	univ
agar	hi
y	en
word	en
walk	en
Sir	en
Shoib	univ
Sham	univ
shadi	hi
roomie	en
qandeel	univ
mil	hi
meet	en
logo	hi
Just	en
IITian	univ
hit	en
Ha	univ
Go	en
give	en
fir	hi
fan	en
endsems	en
cheer	en
bta	hi
btaaa	hi
Bs	hi
afridi	univ
Afrad	univ
Acha	hi
When	en
Virat	univ
tv	univ
tab	hi
Sri	univ
Shadi	hi
Ranjan	univ
plan	en
per	hi
nae	hi
must	en
mjhe	hi
LOL	univ
liyu	hi
let	en
left	en
kbhi	hi
karwa	hi
j√¢ise	hi
Its	en
iim	univ
hue	hi
hmmmm	univ
hell	en
FAN	en
dear	en
chutiya	hi
chl	hi
bring	en
bike	en
bht	hi
bhayya	hi
As	en
ask	en
apnay	hi
Akhtar	univ
acchi	hi
ACCHA	hi
yuvi	univ
wingmates	en
virat	univ
Very	en
Tum	hi
Touda	hi
Toh	hi
theek	hi
talash	hi
sy	hi
Susoom	univ
such	hi
Star	en
Shami	univ
sem	en
See	en
rakh	hi
put	en
pure	hi
poor	en
papa	en
On	en
ok	univ
Oh	univ
Not	en
near	en
nbdu	univ
mast	hi
kro	hi
Kia	hi
khatam	univ
jitenge	hi
H	hi
hoon	hi
hogya	hi
hmm	univ
Hey	en
Here	en
H9	univ
Girnay	hi
ghr	hi
freshie	en
FB	univ
Did	en
Darood	univ
Dab	hi
coz	en
chootiya	hi
Chitral	univ
bohat	hi
bi	hi
Bhaiyya	hi
Beta	hi
Bengaluru	univ
Barfani	univ
banana	en
Amit	univ
akhtar	univ
aisa	hi
achha	hi
Zarai	univ
Yeah	en
Up	en
unki	hi
tou	hi
top	en
till	en
thk	hi
Take	en
son	en
single	en
sex	en
sari	hi
said	en
Rotey	hi
rakhlo	hi
public	en
pit	univ
Note	en
nahe	hi
[\\m/]	univ
move	en
MOOD	en
Mom	en
mom	en
modi	univ
mine	en
midsems	en
mess	en
mar	hi
LoL	univ
Kumar	univ
ksi	hi
krta	hi
Kro	hi
kia	hi
jb	hi
jaiyu	hi
inn	en
Imran	univ
Hue	hi
heart	en
hate	en
haiüëâ	hi
hahaha	univ
gy	hi
ghanta	hi
G2	univ
G1	univ
full	en
floor	en
Fir	hi
Faf	univ
eyes	en
everytime	en
dusro	hi
dost	hi
dasso	hi
chahye	hi
catch	en
Bus	hi
bs	hi
bottle	en
bhut	hi
bhakt	hi
bhaiya	hi
bar	en
band	hi
aunty	en
atleast	en
apki	hi
aisi	hi
agr	hi
age	en
ager	hi
achi	hi
abt	en
6th	univ
yha	hi
yeah	en
Yadav	univ
With	en
wid	en
Whatsapp	univ
WestIndies	univ
wat	en
wanna	en
VOTE	en
usk	hi
urself	en
tune	hi
tho	hi
thora	hi
thaüòú	hi
Tell	en
tabhi	hi
Such	hi
star	en
Srilanka	univ
spot	en
Some	en
smjha	hi
skti	hi
Shoaib	univ
SEX	en
sake	hi
sai	hi
Sachin	univ
re-exam	en
Ravi	univ
Raina	univ
raina	univ
rah	hi
raastravadi	hi
pta	hi
preshan	hi
Police	en
Plz	en
plz	en
pls	en
Pichle	hi
phr	hi
phool	hi
pgp	univ
pehlay	hi
pdai	hi
PAR	hi
Pandey	hi
pandey	hi
okk	en
ny	hi
note	en
niii	hi
Nhi	hi
NEW	en
net	en
neeche	hi
mummy	en
muje	hi
mooh-boli	hi
Modi	univ
mba	univ
ma	hi
Mast	hi
mad	en
LOVE	en
Lol	univ
lohri	hi
logon	hi
living	en
lines	en
liby	en
lets	en
lake	en
Lag	hi
ladko	hi
kumar	univ
kua	hi
Krwa	hi
kozhikode	univ
kon	hi
khelne	hi
karma	hi
jldi	hi
Jay	hi
Jab	hi
jabardasti	hi
IT	en
Ishant	univ
isbar	hi
Irfan	univ
insti	en
inlog	hi
imran	univ
imraan	univ
iit	univ
IITians	univ
iitb	univ
iiml	univ
iimb	univ
ID	univ
hune	hi
hole	en
hojata	hi
hogaya	hi
hmri	hi
hiii	univ
Heheh	univ
Haste	hi
ham	hi
Hahaha	univ
Hahahaha	univ
Hafeez	univ
H10	univ
Gujiya	univ
grt	en
Got	en
god	en
gf's	en
Full	en
Friend	en
fire	en
fap	en
Fan	en
Elaqay	hi
EE	univ
drunk	en
DhokebaazOn	hi
DDCA	en
chootiyas	hi
chappals	hi
chaiye	hi
campusite	en
BUT	en
bunk	en
bt	hi
bolne	hi
bihari	hi
bhot	hi
bhejna	hi
bhasha	hi
bharath	univ
bhal	hi
bhaiyya	hi
bhaijaan	hi
bhabhi	hi
bewakoof	hi
bedsheet	en
bdiya	hi
badhiya	hi
bade	hi
apko	hi
Aik	hi
ahmedabad	univ
achay	hi
aaiyu	hi
9pm	univ
90s	univ
4th	en
4thie	en
3rd	en
Zindabaad	hi
zee	univ
Yuvraj	univ
yhi	hi
YE√ÇR	en
yay	hi
Yamini	univ
Xxxxxxa	univ
www.iitbsecrets.com	univ
wudsay	en
WTF	univ
worldcup	en
Worker	en
Word	en
wingies	en
wifi	en
Whi	hi
wese	hi
Wasim	univ
wasan	hi
waheguru	univ
wagera	hi
vraj	univ
Vivek	univ
vishal	univ
Vikas	univ
Vasai	univ
vartman	hi
US	univ
unko	hi
unkempt	en
unke	hi
unho	hi
Umeed	hi
Ul	univ
uchit	hi
tym	en
total	en
tk	hi
Tiwari	univ
thirdie	en
thats	en
thaa	hi
tbhi	hi
Tazgi	hi
TA	univ
ta	univ
tarf	hi
tallah	hi
T-20	en
Sy	hi
swasth	hi
Suresh	univ
sunhara	hi
Suketu	univ
Sudhar	hi
STAR	en
Standup	hi
sprihanelege	hi
soomro	univ
sonu	univ
Son	en
Single	en
Silk‚Äù	en
silk‚Äù	en
sidey	en
Siddharth	univ
shikhar	hi
sharma	univ
SHAMI	univ
shami	univ
shaandar	hi
set	en
Senkron	hi
sawant	univ
Saurabh	univ
Sath	hi
Sathe	univ
SaReGaMaPa	hi
sanskriti	hi
Sanjay	univ
sangita	hi
Sanghis	univ
samman	hi
SAI	hi
sad	en
Sachi	hi
sachi	hi
Sacchi	hi
Sabr	hi
R	en
Rpt	en
route	en
Rounak	hi
Rithvik	univ
rhe	hi
re-exams	en
Reai	univ
rat	hi
RATE	en
rate	en
Rapais	univ
ran	en
Rania	univ
rang	hi
Rajasthan	univ
Rajan	univ
rahm	hi
raajniti	hi
üò¢Qandeel	univ
py	hi
Pure	hi
ptaaa	hi
protibha	hi
Priyank	univ
ppp	en
pkde	hi
pitega	hi
Phle	hi
phle	hi
phatake	hi
phal	hi
Peg	en
pee	hi
peed	en
patakhe	hi
part	en
parta	hi
parityaag	hi
Pappu	hi
Papa	en
Pandya	univ
Paksitaniyon	hi
Paki	univ
paki	univ
pain	en
Paighamber	hi
pae	hi
$oya	hi
ON	en
Ok	univ
oh	univ
Ohh	univ
Ohhh	univ
Of	en
NO	en
noon	en
Nobody	en
nobody	en
nitish	univ
nimaz	hi
nikleen	hi
nh	hi
NHI	hi
netrito	univ
Netraprabha	univ
Nehra	univ
nautanki	hi
namastey	hi
nahane	hi
Mucchi	univ
mrng	en
moron	en
MoodI	univ
Momino	hi
Moha	univ
Modiji	univ
mith√¢√¢s	hi
minister	en
Mil	hi
mey	hi
Men	en
men	en
meko	hi
mediaHe	hi
mauhit	univ
matka	hi
masle	hi
MANTRI	hi
Manish	univ
manhoos	hi
Mangtay	hi
mam	en
Mahela	univ
mahasabha	hi
Maashallah	hi
maarte	hi
l	univ
lund	hi
loh	hi
Log	hi
liyah	hi
lgta	hi
ley	hi
letey	hi
Leag	hi
layak	hi
Lashen	hi
Larhka	hi
ladkiyo	hi
lachar	hi
Laakhan	univ
kyunki	hi
kutti	hi
kutch	hi
kuki	hi
kriyu	hi
krantikari	hi
kotta	hi
Koti-Koti	hi
kothewali	hi
konse	hi
koHar	hi
Kingu	univ
Kingo	univ
khtm	hi
khilaf	hi
khelegain	hi
khayega	hi
khawateen	hi
khabhi	hi
khaa	hi
KEY	en
key	en
kewal	hi
kese	hi
kena	hi
kejriwal	univ
kehlatey	hi
kebal	hi
Katiyar	univ
Karwaun	univ
karwane	hi
karny	hi
karega.is	hi
karay	hi
karate	en
kaptan	hi
kaney	hi
kamine	hi
Kaisan	hi
Kaash	hi
jyega	hi
jitwa	hi
JINTHA	hi
Jazbati	hi
JAY	hi
jay	hi
jau	hi
jarurat	hi
janaza	hi
jaky	hi
Jaiüôè	hi
JaiHoüëç	hi
Jai$ey	hi
jadeja	hi
‚ÄòJab	hi
isabgol	univ
Inzamam	univ
intiqal	hi
inng	en
i'll	en
IDC	univ
hy	hi
Huu	hi
Hussey	univ
hüòÅ	hi
‚ÄúHuggies‚Äù	univ
HS101	univ
howa	hi
HO	hi
horaha	hi
hook	en
hoke	hi
hogai	hi
hmari	hi
Hitendra	univ
His	en
hinsatmak	hi
himachal	hi
hiiii	en
HEY	en
hey	en
Her	en
hero	en
Hell	en
HDL	univ
HAVE	en
hau	hi
haste	hi
Harshad	univ
H√ÇPP≈∏	en
Ham	hi
haiüòÇüòÇüòÇ	hi
Hahah	univ
HAHAHAHA	univ
H4	univ
H13	univ
guru	hi
‚ÄúGUCCI	univ
God	en
gn	hi
Ghr	hi
Gharib	hi
gf	en
Garv	univ
gal	en
gaii	hi
frd	en
FORI	hi
Foran	hi
fool	en
Film	en
fb	univ
Faqeer	hi
fakka	hi
fail	en
fageeru	hi
FACAD	univ
Everytime	en
ES	univ
ese	hi
esa	hi
EP	univ
Emp	en
else's	en
EILLAN	univ
eh	univ
duüò¥	hi
dun	univ
Dp	en
Dost	hi
Don	en
dnt	en
diyu	hi
dis	en
dimag	hi
dikhade	hi
dika	hi
dikat	hi
Dheere	hi
Dhawan	univ
Dhamaka	hi
Dhakelta	hi
dekhunga	hi
dekhiAb	hi
deekh	hi
Dasharath	univ
darpook	hi
Damaad	hi
damaad	hi
Dainik	univ
Dad	en
dad	en
‚ÄúColgate‚Äù	univ
chutti	hi
chutiyapa	hi
chorh	hi
chorein	hi
CHITHA	hi
chillar	en
Check	en
chat	en
Chashm-e-buddoor	hi
chap	en
Change	en
calor	en
‚ÄúC√¢dbury	univ
business	en
bua	hi
btaya	hi
boldo	hi
Bola	hi
Bohot	hi
bit	en
bittu	hi
Bisleri	univ
bill	en
bichari	hi
bhramin	hi
bhosdini	hi
bhonkna	hi
bhe	hi
Bhencho	hi
Bhejte	hi
Bheek	hi
bhatije	hi
Bhakht	hi
Bhaiya	hi
